NO ./textures/xpms/red_bricks.xpm
SO ./textures/xpms/red_bricks.xpm
WE ./textures/xpms/red_bricks.xpm
EA ./textures/xpms/red_bricks.xpm

F 0,0,0
C 204,204,255

        1111111111111222222222111
        1011000001110000000000001
        10010000000D000000000E00P
111111111011000001110000000000001
10000000001100000111D111111111111
11110111111111011100000010001
11110111111111011101010000001
11000000110101011100000010001
10000000000000001100000010001
10000000000000000001010010001
1100000111010101111101111000111
11110111 1110101 100011000001
11111111 1111111 111111111111




