NO ./textures/xpms/grey_bricks_light.xpm
SO ./textures/xpms/grey_bricks_light.xpm
EA ./textures/xpms/grey_bricks_light.xpm
WE ./textures/xpms/grey_bricks_light.xpm

F 255,255,255
C 0,0,0

11111111111111111111111111111
1S000000000000000000000000001
101D111110110000001011111D101
10100000100000000010100000101
10101110101001110100101110101
10101XD010110110100010DX10101
101011101011D1000100101110101
10100000100D00110000D00000101
1011111D101010D0101011111D101
10000000000101000010000000001
10111100101000101011001110101
100000100D0100001010010001001
10011110110001D10000111000001
1001111001000101D1D1111D10001
1000100D1001001D010DDDD011101
100000110011101001101D1000101
100101001100000D101100101D001
101011100011001000DDD11000101
10000111100100110111D11D11101
1000000000110011D010001010101
10111111100000011010101011101
10D0000010001010001000D00D001
101011101001D00000111D1101101
10101XD0101101011001101111101
10101110101001101100101011001
10100000D010011D110100D010001
10111111101D10001000111D11101
10000000000000000000000000001
11111111111111111111111111111
