NO ./textures/01bricks1.xpm
SO ./textures/04mura.xpm
WE ./textures/04pietrac1.xpm
EA ./textures/04pietrac4.xpm

F 51,204,51
C 204,51,255

11111111111111111
110000000000001
10000000000000111
100000000000000001
1000000N0000001111
100000000000001111
100000000000001
111000000000001
11111111111111
