NO ./textures/01bricks1.xpm
SO ./textures/04mura.xpm
WE ./textures/04pietrac1.xpm
EA ./textures/04pietrac4.xpm

F 51,204,51
C 204,51,255

11111111P111111111
110000000000000001
10000000N000000001
100000000000000001
100000000000000001
100000000000000001
100000000000000001
111111111111111111