NO ./textures/xpms/grey_bricks_light.xpm
SO ./textures/xpms/grey_bricks_light.xpm
EA ./textures/xpms/grey_bricks_light.xpm
WE ./textures/xpms/grey_bricks_light.xpm

F 51,204,51
C 204,51,255

112111211121112111211
100010001000100010001
2000D000D000D000D0002
100010001000100010001
11D111D111D111D111D11
100010001000100010001
2000D000D000D000D0002
100010001000100010001
11D111D111D111D111D11
100010001000100010001
2000D000D0N0D000D0002
100010001000100010001
11D111D111D111D111D11
100010001000100010001
2000D000D000D000D000X
100010001000100010001
11D111D111D111D111D11
100010001000100010001
2000D000D000D000D0002
100010001000100010001
112111211121112111211