NO ./textures/xpms/red_bricks.xpm
SO ./textures/xpms/red_bricks.xpm
WE ./textures/xpms/red_bricks.xpm
EA ./textures/xpms/red_bricks.xpm
F 150,150,150
C 204,204,255

        1111111211111121111112111
        1000000000110000000000001
        1011000001110000001000001
        1001000000D00000001000001
112111111011000001110000001000001
P0000000001100000111D121111112111
11210111111111011100000010001
11110111112121011101010010002
110000001101010111000000D0001
1000000000000000D000000010001
10000000000000001101010010001
11000001110101011111011120N0211
11110111 1110101 101111010001
11112111 1112121 111111111111