NO ./textures/xpms/blue_bricks.xpm
SO ./textures/xpms/blue_bricks.xpm
WE ./textures/xpms/blue_bricks.xpm
EA ./textures/xpms/blue_bricks.xpm

F 214,168,41
C 133,122,91

11111111121P12111111111
10000000200000200000001
10111110102220101111101
10100010102220101000101
10101010000000001010101
10101011111D11111010101
10101000000000000010101
10101111110101111110101
10001 10000100001 10001
11111110111111101111111
10001000D00000D00010001
10001012100N00121010001
10000010D00000D01000001
11111110111111101111111
10001 10000100001 10001
10101111110101111110101
10101000000000000010101
10101011111D11111010101
10101010000000001010101
10100010102220101000101
10111110102220101111101
10000000200000200000001
11111111121P12111111111