NO ./textures/xpms/grey_bricks_light.xpm
SO ./textures/xpms/grey_bricks_light.xpm
EA ./textures/xpms/grey_bricks_light.xpm
WE ./textures/xpms/grey_bricks_light.xpm

F 51,204,51
C 204,51,255

111X111
1000001
100N001
1000001
1111111
