NO ./textures/xpms/grey_bricks_light.xpm
SO ./textures/xpms/grey_bricks_light.xpm
EA ./textures/xpms/grey_bricks_light.xpm
WE ./textures/xpms/grey_bricks_light.xpm

F 255,255,255
C 0,0,0

11111111111111111
1000000000W100001
10110111111101101
10100000100000101
10111111111110111
10000000000000101
10111110111111101
10100010100000001
10101010101111101
11101010100000101
10101110111110101
10100000001000101
10110111111110101
10000000000000101
111111111111111X1