NO ./textures/xpms/blue_bricks.xpm
SO ./textures/xpms/blue_bricks.xpm
WE ./textures/xpms/blue_bricks.xpm
EA ./textures/xpms/blue_bricks.xpm

F 214,168,41
C 133,122,91

11111111111111111111111
10000000000000000000001
10111111111011111111101
10100000001010000000101
10101111101010111110101
10100000101010100000101
10111110101010101111101
10000000101010100000001
11111111101010111111111
10000000001010000000001
10111111111011111111101
10001000100000100010001
10001010100000101010001
10000010100000101000001
11111110111111101111111
10001 10000100001 10001
10101111110101111110101
10101000000100000010101
10101011111111111010101
10101010002 20001010101
10100010102 20101000101
10111110102 20101111101
100000002E0P20200000001
11111111121112111111111