NO ./textures/01bricks1.xpm
SO ./textures/04mura.xpm
WE ./textures/04pietrac1.xpm
EA ./textures/04pietrac4.xpm

DOOR ./textures/01bricks1.xpm

F 51,204,51
C 204,51,255

        1111111111111111111111111
        1000000000110000000000001
        1011000001110000000000001
        10010000000D0000000000001
111111111011000001110000000000001
10000000001100000111D111111111111
11110111111111011100000010001
11110111111111011101010000001
11000000110101011100N00010001
10000000000000001100000010001
10000000000000000001010010001
1100000111010101111101111000111
11110111 1110101 100011000001
11111111 1111111 111111111111




