11111111111
10000000001
 1000N0001
10000000001
11111111111